9x9
1(1),0,0,2(2),0,10,0,0,0
0,12,0,0,0,0,0,0,0
0,0,0,0,0,0,0,0,0
11,0,0,0,0,0,0,0,11
0,0,0,0,10,0,0,0,0
0,2(1),0,12,0,0,2(3),0,0
0,0,10,0,0,0,0,0,0
0,0,0,0,0,11,0,0,0
10,0,0,0,0,0,0,0,10