12x12
1(1),0,0,0,0,0,2(0),0,0,0,0,0
0,0,0,0,10,0,0,0,0,0,0,10
12,11,0,12,0,0,0,0,0,0,0,0
0,0,0,0,0,0,0,0,12,0,0,0
2(1),0,0,0,0,11,0,12,10,12,0,0
0,0,0,12,0,0,0,0,0,0,0,0
0,0,0,0,12,0,0,0,0,0,2(1),11
0,12,0,0,0,0,0,0,0,0,0,0
0,0,0,0,0,0,0,0,0,0,0,0
0,0,0,0,0,0,0,0,0,0,0,12
0,0,0,0,0,0,0,0,11,12,12,12
2(1),0,0,0,0,0,0,0,0,0,0,10